AAAAAAAAAAAAAAAAAAAA
AAAAAAAAAAAAAAAAAAAA
AAAAAAAAAAAAAAAAAAAA
AAAAAAAAAAAAAAAAAAAA
AAAAANAAAAANAAAAAAAA
AAAAAAAFFAAAAAAAAAAA
AAAMFFFFFFAMAAAAAAAA
AAAFFFFFFFFFFAAAAAAA
AAAAAAAAAAAAAAAAAAAA
AAAAAAAAAAAAAAAAAAAA
AAAAAAAAMAAAAAAAAAAA
AAAAPAAFFFMAFFAAAAAA
AAAFFFFFFFFFFFFAAAAA
NAMAAAAAAAFAAAAMAAAA
FFFFFFFFFFFFFFFFFFFF