AAAAAAAAAAAAAAAAAAAA
AAAAAAAAAAAAAAAAAAAA
AAAAAAAAAAAAAAAAAAAA
AAAAANNNNAAAAAAAAAAA
AAAAAAAAAAAAAAAAAAAA
AAAAAAAFFAAAAAAAAAAA
AAAFFFFFFFFFFAAAAAAA
AAAAAAAAAAAAAAAAAAAA
AAAAAAAAAAAAAAAAAAAA
AAAAAAAAAAAFFFFFAAAA
AAAAAAAAAAAAAAAAAAAA
AAAAAAAAAFAAAAAAAAAA
AAAAAAAAAAAAAAAAAAAA
AAAAPAAAAAAAAAAAAAAA
FFFFFFFFFFFFFFFFFFFF