AAAAAAAAAAAAAAAAAAAA
AAOAAAOAAAAOAAAAOAAA
AAAAAAAAAAAAAAAAAAAA
AAAAOAAAOAAAAOAAAAAA
AAAFFFFFFFFFFFFFFAAA
AAAAAAAAAAAAAAAAAAAA
AAAAAAAAAAAAAAAAAAAA
AAAAAAAAAPAAAAAAAAAA
AAAAAAFFFFFFFAAAAAAA
AAAAAAAAAAAAAAAAAAAA
AFAAAANAAANAAAANAAFA
AAFFFFFFFFFFFFFFFFAA
AAAAAAAAAAAAAAAAAAAA
AAAAAAAAAAAAAAAAAAAA
FFFFFFFFFFFFFFFFFFFF