AAAAAAAAAAAAAAAAAAAA
AQAAQAAQAAQAAQAAQAAA
AAAAAAAAAAAAAAAAAAAA
AAAAAAAAAAAAAAAAAAAA
AAAAAAAAAAAAAAAAAAAA
AAAAAAAAABAAAAAAAAAA
AAAAAAAAAAAAAAAAAAAA
AAAAAAAAAAAAAAAAAAAA
AAAAAAAAAAAAAAAAAAAA
AAAAAAAAAAAAAAAAAAAA
AAAAAAAAAAAAAAAAAAAA
AAFFFFAAFFFFAAFFFFAA
AAAAAAAAAAAAAAAAAAAA
AAAAAAAAAPAAAAAAAAAA
FFFFFFFFFFFFFFFFFFFF