AAAAAAAAAAAAAAAAAAAA
AAAAAAAAAAAAAAAAAAAA
AAAAAAAAAMAMAAMAAMAA
AAAAAAFFFFFFFFFFFFFF
AMAMAAAAAAAAAAAAAAAA
FFFFFFFFFFFAAAAAAAAA
AAAAAAAAAAAAAAAAAAAA
AAAAAAAAAAAAAAAAAAAA
AAAAAAAMAAAAMAAAMAAA
AAAAAFFFFFFFFFFFFFFF
AMAMAAAAAAAAAAAAAAAA
FFFFFFFFFFFFFFAAAAAA
AAAAAAAAAAAAAAAAAAAA
AAPAAAMAAAAAAAMAAAAA
FFFFFFFFFFFFFFFFFFFF