AAAAAAAAAAAAAAAAAAAA
AAAAAAAAAAAAAAAAAAAA
AAAAAAAAAAAAAAAAAAAA
AFAOFFOAFAAFAOFFOAFA
AAFFAAFFAAAAFFAAFFAA
AAAAAAAAAAAAAAAAAAAA
AAAFAAFOAFOAFOAFAAAA
AAAAFFAFFAFFAFFAAAAA
AAAAAAAAAAAAAAAAAAAA
AAAAAAAAAAAAAAAAAAAA
AAAAAAAAAAAAAAAAAAAA
AAAAAAAAAAAAAAAAAAAA
AAAAAAAAAAAAAAAAAAAA
AAAAAAAAAPAAAAAAAAAA
FFFFFFFFFFFFFFFFFFFF