AAAAAAAAAAAAAAAAAAAA
AOAAAAAAAAAAAAAAAAOA
AAAAAAAAAAAAAAAAAAAA
AAAAOAAAAAAAAAAOAAAA
AAAAAAAAAAAAAAAAAAAA
AAAAAAAAAAAAAAAAAAAA
AAAAAAAAAAAAAAAAAAAA
AAAAAAAAAAAAAAAAAAAA
AAAAAAAAAAAAAAAAAAAA
AAAAAAAAAAAAAAAAAAAA
AAAAAAAAAAAAAAAAAAAA
AAAAAAAAAAAAAAAAAAAA
AAAAAAAAFFFAAAAAAAAA
MAAAAAAAAPAAAAAAAAAM
FFFFFFFFFFFFFFFFFFFF