AAAAAAAAAAAAAAAAAAAA
AAAAAAAAAAAAAAAAAAAA
AAAAAPAAAAAAAAAAAAAA
AAFFFFFFFFAAAAAAAAAA
AAAAAAAAAAAAAAAAAAAA
AAAAAAAAFFFFFAAAAAAA
AAAAAAAAAAAAAAAAAAAA
AFFFFFFFFFAAAAAFFFAA
AAAAAAAAAANAAANAAAAA
AAAAAAAAFFFFFFFFAAAA
AAAAAAAAAAAAAAAAAAAA
AAAMAMAAMAAMAAAAAAAA
AAAFFFFFFFFFFFFAAAAA
AAAAAAAAAAAAAAAAAAAA
FFFFFFFFFFFFFFFFFFFF