AAAAAAAAAAAAAAAAAAAA
AAAFFFAAAAFFFAAAAAAA
AAFAAAAAAFAOAAAAAAAA
AAFAAAAAAAFFAAAAAAAA
AAFAAAAAAAAAFAAAAAAA
AAAFFFAAAFFFAAAAAAAA
AAAANAAAAAAAAAAAAAAA
AAAFFFAAAAFFFAAAAAAA
AAFAAAAAAFAOAAAAAAAA
AAAFFAAAAAFFFAAAAAAA
AAAAAFAAAFAAAAAAAAAA
AAFFFAAAAAFFFAAAAAAA
AAAAAAAAAAAAAAAAAAAA
AAMAAAAAPAAAAAAAAAAA
FFFFFFFFFFFFFFFFFFFF